9, D, D, 5, 4, 9, 5, D, C, 8
2, A, A, 8, 9, 6, 9, 6, 3, 6
9, 6, B, 6, 3, C, A, 9, D, C
3, C, 3, D, 5, 6, 3, 6, A, 6
8, 3, 4, 3, C, 9, 5, 5, 6, 9
7, 5, D, C, A, 2, 5, C, 9, 6
8, 9, 6, 3, 6, 9, 4, 3, 6, 8
B, 6, 9, D, 4, 3, D, D, 5, E
B, C, A, 3, 5, C, A, B, 5, 6
2, 3, 6, 1, 5, 7, 6, 3, 5, 4
